ITC 4-004,ITC 5-056,ITC 1-068 + 072,ITC 3-008,ITC 3-110,ZZ SC/T,NH 207,NH 209,CR 2L,NH 205,RA 3231,OH 218,OH 215,CR 2H,OH 111,OH 115,ITC 4-112,SP 3,NH 115,ITC 4-146,SP 2,CR 3C,ITC 4-024,OH 210,CR 2K,HR C101,ZZ THERM/T,CR 3A,RA 2504,SP 5,RA 4237,ITC 0-143,CR 3B,SP 4,RA 2502,HT 1100,HT 900,WA 3,NH 124,CI T300,CR 3E,CU B209,CR 2M,SP 6,RA 3334,OH 211,OH 113,CR 2N,CR 4A,OH 110,CR 3H,HB 2B,HT 700B,HT 500A,RA 4231,HB 2D,CR 3D,CR 2G,SP 1,WA 4,HT 500B,HB 2F,RA 2231,OH 116,RA 3336,ITC 5-108,OH 114,RA 1501,HB 2A,HR N109,HB 2E,RA 4336,RA 2334,RA 2336,RA 4334,WA 2,HB 2C,CU PC-zaal 1,RA 2501,SP 7,CU PC-zaal 2,RA 2237,CU C238,HT 700A,OH 112,WA 1,CR 3F,CU B103,CU B101,WA 1+2,WH 122 Metaalwerkplaats CTW,WH 215,RA 2503,ITC 3-128,CU B200A,ZI A138,ITC 0-065,ITC 3-004,VR 501,VR 583,WH 216 Modelwerkplaats CTW,VR 559,ITC 2-010,ZI W1,WH 217,VR Audiozaal,ITC 3-137,HT 505,HT 703,HT 503,HT 501,HT 509,ITC 5-108 + 110,ZI W2,ZZ OH 218/T,ZZ NH 205/T,ZI Westzaal,RA 4411,ITC 5-008,RA 4247,ZZ NH 209/T,RA 4110,ZZ EXTERN,ZI W3,ITC 2-038,GY 1.78 COTF,HT 701,ZI W4,RA 5148,RA 3245,HT 1105,HT 1107,RA 5110,GY 1.79 Inform,RA 2314,RA 3112,ITC 5-136,HT 1111,HT 1113,VR Agora,HT 1109,HT 807,ZZ NH 207/T,HT 805,HT 801,ZZ OH 215/T,HT 1013,HT 1015,HT 1011,HT 803,WH 221,HT 1001,HT 1007,HT 1005,HT 911,ZZ SP 3/T,GY 1.86-1.88 Ideate,HT 909,HT 1009,ZZ SP 4/T,HT 905,HT 907,HT 1101,HT 1003,HT 1103,ITC 2-004,GY 1.79 Inform (gesloten ruimte),HT 903,ZZ OH 115/T,ZZ CR 2K/T,ZZ RA 2502/T,HT 913,HT 901,RA 2209,HT 1115,HT 915,GY 1.86-1.88 Prototype (voorheen CREATE),ZZ NH 124/T,ITC 1-032,GY 1.78 (cvdt),ZZ OH 116/T,ITC 3-145,ZZ OH 210/T,GY 1.86-1.88 (semi-open projectruimte Ideate),ZZ HB 2E/T,ZZ OH 111/T,GY 1.86-1.88 (open projectruimte Create),ZZ CR 3C/T,ZZ NH 115/T,CR 4022A,HT 1203,HT 1209,HT 1201,HT 1205,HT 1207,ZZ OH 211/T,GY 1.81a Conceptualize,ZZ HB 2A/T,ZZ HB 2F/T,ZZ RA 4336/T,CR 4132,ZZ HB 2D/T,ZZ OH 113/T,ZZ RA 2504/T,CR 4620,ZZ CR 4A/T,ZZ CR 3F/T,ZZ HT 1100/T,ZZ CR 2M/T,WH 223,ZZ CR 3B/T,CR 4022B,CR 4028A,ITC 5-144,ZZ CR 2N/T,ZZ RA 4231/T,ZZ RA 4237/T,CR 4134,ITC 2-032,ZZ CR 3D/T,ZZ HB 2B/T,ZZ RA 4334/T,ZZ HB 2C/T,ZZ OH 110/T,ZZ SP 5/T,ZZ CR 2H/T,ZZ RA 3336/T,ZZ OH 112/T,CR 4022C,ZZ CR 2L/T,ZZ HT 900/T,ZZTCP VR SL3,ZZ RA 3334/T,ZZTCP VR SL1,ZZ RA 3231/T,ZZ CR 3H/T,CR 4028B,VR 275M (previously VR 2.11) (Library),VR 275O (previously VR 2.12) (Library),ZZ CR 3E/T,ZZ HT 700A/T,VR 275J (previously VR 2.08) (Library),VR 275Q (previously VR 2.14) (Library),VR 275G (previously VR 2.06) (Library),VR 275K (previously VR 2.09) (Library),VR 275L (previously VR 2.10) (Library),VR 275P (previously VR 2.13) (Library),ZZTCP VR SL2,VR 275C (previously VR 2.03) (Library),VR 275F (previously VR 2.05) (Library),ZZ CR 3A/T,ITC 3-141,VR 193A (previously VR 1.12) (Library),VR 2.02 (Library),VR 2.03 (Library),VR 2.04 (Library),VR 2.05 (Library),VR 2.06 (Library),VR 2.08 (Library),VR 2.09 (Library),VR 2.10 (Library),VR 275B (previously VR 2.02) (Library),VR 275E (previously VR 2.04) (Library),HT 813,VR 193D (previously VR 1.14) (Library),GY 1.81-1 eWorkshop,GY 1.86-1 mWorkshop,VR 1.12 (Library),VR 1.14 (Library),VR 2.13 (Library),VR 2.14 (Library),VR Amphitheater,ZZ OH 114/T,HT 1211,HT 1213,ZZ SP 7/T,RA 4108,RA 4409,CR 4724C,CR 4724D,HT 811,HT 809,RA 5108,ZZ RA 2336/T,ZZ CU B101/T,ZZ HT 500A/T,ZZ HT 700B/T,RA 4245,ZZ CR 2G/T,ZZTCP VR 501,CR 4632,ZZ WA 1/T,ZZ SP 6/T,RA 3106,RA 2253,ZZ RA 2334/T,ZZ WH 215/T,ZZTCP VR 583,CR 4724A,CR 4724B,CU B205C,RA 2207,ZZ CU B103/T,ZZTCP VR 559,HT 815,ITC 5-112,VR 2.11 (Library),ZZ RA 2237/T,ITC 3-131,VR 258 (previously VR 2.E) (Library),VR 275R (previously VR 2.15) (Library),ZZ RA 1501/T,ZZ RA 2501/T,VR 191B (previously VR 1.23) (Library),ZZ RA 2231/T,CR 4624,HT 1215,VR 257 (previously VR 2.D) (Library),ZZ SP 1/T,ZZTCP VR SL4,VR 1.01 (Library),VR 193K (previously VR 1.20) (Library),VR 2.07 (Library),VR 247 (previously VR 2.A) (Library),VR 248 (previously VR 2.B) (Library),VR 256 (previously VR 2.C) (Library),VR 275R (Library),VR 275T (Library),VR 275T (previously VR 2.16) (Library),ITC 0-146,SP PR 1,VR 1.19 (Library),VR 1.20 (Library),VR 1.23 (Library),VR 170 (previously VR 1.01) (Library),VR 191B (Library),VR 193A (Library),VR 193K (Library),VR 2.12 (Library),VR 247 (Library),VR 248 (Library),VR 256 (Library),VR 257 (Library),ZZ HT 500B/T,ZZ WA 2/T,ITC 5-002,ITC 5-110,VR 1.18 (Library),VR 2.01 (Library),VR 2.A (Library),VR 2.B (Library),VR 2.C (Library),VR 2.D (Library),VR 2.E (Library),VR 258 (Library),VR 275H (previously VR 2.07) (Library),ZI W3A,ZI W3B,ZZ CI T300/T,ZZ CU C238/T,ZZ HR C101/T,ZZ VR 559/T,ZZ WA 4/T,GY 0.93 Emphathise/Interact,"GY 1.86-1 (werkplaats hout, metaal)",ITC 1-030,VR 1.21 (Library),VR 1.22 (Library),VR 170 (Library),VR 193J (Library),VR 2.16 (Library),VR 275M (Library),VR 275O (Library),ZZ VR 501/T,SP PR 3,VR 275H (Library),VR 275J (Library),VR 275K (Library),VR 275L (Library),VR 275P (Library),ZZ RA 2503/T,ZZ WH 217/T,GY 0.98 Capture,GY F Playground,ITC 0-001,RA 3247,RA 3411,SP PR 2,SP PR 4,VR 193L (previously VR 1.21) (Library),VR 275G (Library),ZZ SP 2/T,ZZ VR 583/T,GY 0.97 Invite,VR 1.13 (Library),VR 1.15 (Library),VR 1.16 (Library),VR 1.17 (Library),VR 193J (previously VR 1.19) (Library),VR 193N (previously VR 1.22) (Library),VR 2.15 (Library),VR 275Q (Library),ZZ CU B209/T,ZZ HR N109/T,ZZ VR Audiozaal/T
0,0,0,0,0,310,314,444,391,290,459,408,86,672,812,319,0,858,356,0,480,424,0,505,767,308,0,250,413,463,165,0,282,489,453,231,528,402,177,910,229,308,323,332,429,259,205,324,342,151,373,242,273,326,211,237,195,223,393,278,304,229,269,114,232,0,112,336,204,316,164,201,197,190,199,327,144,242,315,369,283,217,304,117,94,220,108,165,176,172,21,126,213,0,95,69,0,0,0,0,39,0,0,105,26,51,0,25,25,22,22,14,0,60,50,38,46,29,0,31,62,35,42,68,0,0,25,63,7,22,31,31,7,0,16,20,0,27,27,31,27,12,28,12,12,24,57,58,57,12,17,57,57,57,49,12,0,47,57,30,55,37,34,57,27,0,0,34,30,8,7,37,45,15,27,37,0,33,0,0,29,0,16,0,3,11,0,8,16,0,0,0,0,0,0,9,0,5,1,0,29,0,15,0,15,2,1,17,6,68,0,0,0,0,2,0,0,24,0,1,1,0,1,1,2,9,0,0,0,3,10,0,3,0,2,6,0,0,0,0,1,0,0,0,0,0,0,0,0,0,0,0,0,0,0,0,0,0,0,0,0,0,0,0,0,0,0,0,0,0,0,0,5,0,0,6,23,23,12,0,0,0,21,0,0,5,3,19,0,0,18,9,5,16,15,0,0,0,4,4,0,14,0,0,0,0,4,0,0,0,0,0,0,0,0,0,0,0,3,0,0,0,0,0,0,0,0,0,0,0,0,0,0,0,0,0,0,0,0,0,0,0,0,5,0,0,0,4,0,4,4,4,4,4,0,0,5,5,0,0,2,0,0,0,0,0,4,4,0,0,4,0,0,0,2,0,0,0,0,0,0,0,0,0,0,2,0,0,0,0,0,0,0,0,0,0,0,0,0,0,0,0,0,0,0
122,69,121,74,180,1105,487,522,834,454,912,955,922,653,512,405,73,469,519,70,622,670,3,458,445,431,232,685,584,664,649,66,744,457,532,405,411,592,358,371,657,715,465,574,542,651,471,477,559,465,465,606,504,500,529,586,509,443,518,509,509,482,480,567,332,2,496,391,481,372,543,389,363,302,317,228,402,545,297,350,494,355,320,402,359,427,297,353,381,256,271,321,306,11,198,190,10,1,120,155,84,145,60,221,225,111,10,158,153,157,151,153,0,116,109,119,77,100,2,98,70,88,12,70,0,0,21,67,78,79,56,56,75,0,77,77,0,56,56,98,56,11,83,9,12,64,52,50,52,9,41,51,50,50,20,62,0,20,50,73,14,19,56,33,56,1,67,14,61,70,50,20,1,48,56,32,0,47,2,0,47,0,67,65,44,53,48,20,55,48,2,2,2,2,2,36,0,21,29,34,32,37,24,26,16,19,32,37,32,0,42,32,48,0,30,24,23,36,0,33,22,21,15,32,24,20,16,26,32,29,27,0,23,0,11,23,32,2,2,23,28,2,8,8,1,1,7,0,3,3,15,10,6,38,38,38,38,38,37,37,37,1,1,16,1,0,0,32,32,32,32,12,15,2,2,19,0,0,0,0,17,17,0,12,11,7,10,0,3,0,0,7,8,0,0,4,1,0,0,0,0,0,5,0,1,0,7,1,10,2,1,4,10,8,2,0,2,3,3,0,7,7,7,2,2,2,0,0,1,0,1,6,6,6,6,0,0,0,6,0,0,0,0,1,6,0,0,1,5,1,1,1,1,1,0,1,0,0,2,5,2,3,2,0,0,0,0,0,0,0,0,0,0,0,1,0,0,0,0,0,2,3,0,0,1,0,2,1,2,2,0,2,1,0,1,1,1,1,1,1,1,0,1,1,1
2581,2850,2822,2412,2593,731,449,462,446,330,376,372,686,340,372,414,964,299,402,870,408,420,460,320,266,252,716,425,321,251,423,954,343,277,268,371,328,307,305,159,372,311,433,369,226,275,321,368,295,307,331,370,335,262,335,330,374,295,211,336,257,321,234,290,338,1039,301,247,291,263,254,245,282,332,244,195,331,183,290,211,169,198,212,296,264,97,168,191,169,180,325,107,124,19,224,193,560,533,276,248,303,275,203,72,87,72,357,88,92,82,85,86,153,72,94,63,59,81,237,81,36,77,29,61,213,82,92,53,82,80,45,44,77,72,75,79,128,39,39,29,32,88,39,87,82,40,46,46,46,80,71,44,44,44,78,64,49,78,38,36,67,80,45,44,45,137,66,75,32,40,68,61,70,45,39,50,18,23,113,109,28,106,20,38,37,23,45,46,13,41,22,22,22,22,22,25,2,41,42,42,0,34,30,50,38,46,26,15,19,0,23,34,18,0,20,33,30,0,60,21,24,35,26,17,16,17,30,21,17,13,11,0,19,0,30,6,12,41,41,14,11,40,34,33,40,40,34,0,36,36,15,28,32,0,0,0,0,0,0,0,0,36,36,12,32,0,0,0,0,0,0,7,10,22,21,0,0,0,10,22,0,0,0,8,9,2,6,0,9,0,0,2,4,0,0,11,13,0,10,10,0,0,9,0,5,12,0,6,0,8,9,2,0,1,6,8,3,5,2,0,0,0,0,5,5,5,4,4,6,6,1,0,0,0,0,4,4,4,0,3,3,3,3,0,0,5,5,0,0,0,0,0,0,0,5,4,0,0,3,0,0,2,0,0,4,4,0,0,4,4,0,4,4,4,0,3,3,3,3,1,1,0,0,0,1,0,0,1,0,0,0,0,0,0,0,0,0,0,0,0,0,1,0,0,0
1911,1451,1409,1306,273,494,952,587,633,1086,353,296,297,301,260,739,847,213,389,847,237,237,1286,418,234,610,647,298,323,288,333,608,239,350,299,421,230,201,537,64,239,154,238,184,252,251,441,237,186,419,207,133,213,209,178,144,213,314,148,146,171,200,247,232,243,116,207,152,126,160,110,253,237,234,267,277,117,53,102,56,37,185,101,107,124,104,206,81,71,50,138,125,52,667,68,105,0,24,144,130,94,96,177,34,67,137,0,60,60,60,60,62,144,25,15,42,50,29,0,25,41,25,146,20,0,93,63,16,31,16,34,34,31,111,18,11,58,33,32,23,34,61,22,61,62,29,8,8,6,61,20,5,6,5,9,17,94,9,6,10,9,9,6,5,10,0,0,9,8,9,2,9,9,17,2,2,96,12,0,0,3,0,3,0,17,7,0,16,6,0,33,33,32,32,32,4,74,15,7,4,18,8,10,2,0,7,12,2,12,0,3,0,0,64,10,6,9,0,0,5,12,3,14,8,15,5,5,3,0,4,1,24,3,30,4,10,0,0,0,6,3,0,0,0,0,0,0,28,0,0,9,0,0,0,0,0,0,0,0,0,0,0,0,1,0,32,32,0,0,0,0,11,0,2,2,0,0,0,0,0,1,1,0,0,0,5,1,0,4,8,0,0,0,0,0,0,1,10,0,0,14,0,0,7,1,0,0,4,0,0,0,4,0,0,0,0,2,0,0,8,0,0,0,0,0,0,3,3,0,0,4,0,0,0,0,2,2,2,0,3,3,3,3,0,0,0,0,0,0,0,0,0,0,0,0,0,0,0,0,0,1,0,0,4,0,0,0,0,0,0,0,0,0,0,0,0,0,0,0,2,0,0,2,0,0,0,0,0,0,0,2,0,1,1,0,0,0,0,0,0,0,0,0,0,0
0,0,0,0,0,22,295,449,12,120,87,35,38,17,20,20,0,7,152,0,33,13,0,29,11,122,97,22,29,3,70,0,19,5,21,125,22,16,140,5,11,4,32,15,21,31,18,14,11,48,5,13,29,55,66,13,11,15,5,6,27,27,25,16,14,0,41,9,19,8,30,11,19,12,11,6,31,0,4,1,0,17,7,12,18,8,29,16,8,117,20,38,5,0,6,26,0,0,9,15,10,1,0,2,0,20,0,0,0,0,0,0,0,2,5,1,22,3,0,4,23,5,1,2,0,31,0,1,1,0,30,30,1,5,1,0,0,30,30,0,30,3,0,2,0,9,2,2,2,1,12,2,2,2,0,1,12,0,2,0,0,0,2,2,2,0,0,0,0,2,1,0,1,1,0,0,6,1,0,0,0,0,0,0,0,0,0,0,0,0,31,31,31,31,31,10,6,0,1,0,0,0,0,0,8,0,0,0,0,0,0,0,0,0,1,0,0,0,0,0,0,0,2,0,1,0,0,0,0,0,0,25,0,18,0,0,0,0,0,0,0,0,0,0,0,0,0,13,0,0,0,0,0,0,0,0,0,0,0,0,0,0,0,5,0,0,0,0,0,0,0,0,0,1,1,0,0,0,0,0,4,3,0,1,0,1,0,0,3,11,0,0,0,0,0,0,0,5,0,0,0,0,0,7,5,0,0,0,0,0,0,0,0,0,1,0,1,0,0,0,0,0,0,0,0,0,0,0,0,0,0,0,0,0,0,0,0,0,0,0,0,0,0,0,0,0,0,0,0,0,0,0,0,0,0,0,0,0,0,0,0,0,3,0,0,0,0,0,0,0,0,0,0,0,0,0,0,0,0,0,0,0,0,2,0,0,0,0,0,0,0,0,0,0,0,0,0,0,0,0,0,0,0,0,0
